#012000 #023000 #013000 #030000 #011000 #023000 #063100 #062100 #032000 #020000 #030000 #051000 #022000 #053000 #013100 #072100 #183000 #191000 #110000 #122100 #111100 #153100 #161100 #160000 #122000 #132000 #100000 #111000 #142000 #111000 #121000 #143000 #131000 #151000 #131000 #153000
#021000 #033000 #040000 #022000 #000000 #052000 #040000 #003000 #013000 #050000 #050000 #000000 #042100 #043100 #042100 #093100 #081100 #170000 #132100 #111100 #102100 #130100 #160100 #140100 #161100 #101100 #163000 #151000 #131000 #133000 #133000 #113000 #140000 #151000 #111000 #113000
#040000 #003000 #041000 #033000 #030000 #033000 #031000 #043000 #041000 #063000 #043000 #040000 #020000 #062100 #000100 #050100 #072000 #170000 #142100 #130100 #103100 #131100 #130100 #123100 #100100 #123000 #151000 #103100 #101000 #111000 #130000 #153000 #141000 #160000 #143000 #162000
#000000 #042000 #000000 #061000 #040000 #003000 #063000 #003000 #031100 #062100 #043000 #012000 #042000 #040100 #053100 #000100 #072100 #170000 #143000 #110000 #163100 #110100 #152100 #112100 #101100 #112000 #101000 #110000 #122000 #131000 #150000 #122000 #101000 #110000 #120000 #143000
#052000 #033000 #033000 #052000 #042000 #033000 #041000 #050000 #031100 #000100 #053000 #042000 #020000 #050000 #032100 #090100 #082000 #170000 #143000 #140100 #112100 #100100 #110100 #101100 #152100 #113100 #101100 #160100 #143000 #163000 #150000 #123000 #143282 #130000 #112000 #142000
#050000 #021000 #051000 #030000 #050000 #032000 #061000 #023000 #042000 #011000 #022000 #032100 #031100 #040000 #053000 #072100 #180000 #192000 #140100 #121100 #110100 #103000 #122000 #140000 #121100 #133100 #161100 #122000 #153000 #102000 #102000 #141000 #160000 #111000 #110000 #102000
#030100 #030000 #041000 #000000 #032000 #042100 #021100 #052000 #041000 #052000 #061100 #061100 #000100 #051100 #030000 #072000 #170000 #100100 #121100 #120000 #131000 #110000 #123000 #160000 #152000 #101000 #163000 #132000 #153000 #121100 #122000 #153000 #122000 #120000 #103000 #111000
#030100 #001100 #053000 #050000 #023000 #031000 #020000 #053000 #000000 #042000 #030000 #051100 #030100 #002100 #011000 #072000 #170000 #151000 #111000 #151000 #133000 #122100 #162000 #151000 #140000 #102000 #162000 #152000 #122000 #140000 #151000 #102000 #122000 #160000 #131000 #163000
#032100 #033100 #042000 #023000 #051000 #032000 #021000 #021100 #060000 #062000 #050100 #021100 #030100 #061100 #090100 #082000 #170000 #103000 #142000 #133000 #152000 #141000 #163000 #162100 #142100 #161100 #103000 #122000 #140000 #131100 #151100 #142000 #143000 #163000 #103100 #142100
#023100 #012000 #062000 #013100 #033100 #061100 #043100 #003000 #041000 #020000 #012100 #021100 #020100 #090100 #082000 #180000 #192000 #132000 #133000 #130100 #150000 #141000 #112100 #163100 #111000 #150000 #123000 #113000 #100100 #143100 #112000 #100000 #151000 #121000 #133000 #142000
#063000 #042000 #000000 #012000 #052000 #032680 #012000 #032000 #061000 #031100 #062100 #021100 #090100 #082100 #180000 #192000 #131000 #133000 #103000 #140000 #141000 #143100 #113100 #113000 #110000 #113000 #162000 #120000 #133000 #162000 #150000 #121000 #131000 #121000 #113000 #162000
#033000 #052000 #053000 #050000 #032000 #051000 #061100 #050100 #043000 #012000 #032100 #050100 #072000 #180000 #192000 #151100 #160100 #143000 #130000 #130000 #132000 #153100 #132000 #152000 #112000 #110000 #163000 #120000 #143000 #102000 #132000 #102000 #163000 #110000 #120000 #152000
#033000 #051000 #043000 #000000 #052000 #033100 #041100 #003100 #012100 #060000 #000100 #090100 #082000 #170000 #102000 #160000 #123000 #143000 #163000 #142000 #140000 #143000 #132000 #111000 #142000 #101000 #113000 #143000 #143100 #152100 #163000 #153000 #142000 #123000 #161000 #141000
#003000 #031000 #041100 #063000 #061000 #042000 #013100 #050100 #031100 #003100 #090100 #082000 #180000 #192000 #140000 #143000 #131000 #160000 #141000 #123000 #122000 #142000 #160000 #143000 #102000 #112000 #113000 #120000 #160000 #151000 #153000 #112000 #140000 #123000 #110000 #101000
#023000 #061000 #032100 #090100 #073000 #073000 #073000 #073100 #073100 #073100 #082000 #180000 #192100 #131100 #122100 #122100 #121000 #142000 #143000 #111000 #100000 #112000 #152100 #101100 #150100 #160100 #133000 #143000 #112100 #101100 #113000 #132000 #143100 #111100 #100000 #160000
#011000 #051100 #090100 #082000 #180000 #171000 #171000 #171000 #171000 #171000 #171000 #192000 #100000 #141000 #151100 #133100 #163100 #141100 #142000 #102100 #143100 #101100 #111100 #150100 #120100 #122100 #132100 #121000 #141100 #102100 #160000 #103000 #100000 #121000 #100000 #110000
#010100 #090100 #082100 #180100 #192000 #121000 #110000 #163000 #151000 #103000 #140000 #122000 #153000 #101000 #122100 #103100 #131100 #132100 #120100 #150100 #120100 #132100 #162100 #102000 #113100 #113100 #161100 #162000 #121000 #161000 #153000 #123000 #121000 #122000 #190000 #173000
#073100 #082100 #180000 #192000 #140000 #141000 #112000 #132100 #100100 #141100 #152100 #162100 #162100 #100000 #130000 #133000 #150100 #152100 #160100 #153100 #133100 #140000 #143000 #123000 #120000 #101000 #110000 #162000 #190000 #173000 #173000 #173100 #173100 #173000 #182000 #080100
#171000 #171000 #192000 #111000 #100000 #161100 #121100 #111100 #102100 #111100 #142100 #111100 #160100 #102100 #133000 #130000 #100000 #100000 #102000 #160100 #153100 #120100 #143100 #141100 #143100 #160000 #190000 #173000 #182000 #080100 #071100 #071100 #071100 #071100 #071000 #092000
#123000 #142000 #143000 #163000 #113100 #103100 #100100 #112100 #140100 #122100 #132100 #113000 #113000 #111000 #163000 #150000 #142000 #143000 #163000 #141000 #162000 #153100 #113100 #113100 #132000 #190000 #182000 #080000 #071100 #092100 #010100 #063100 #003100 #041000 #031000 #000000
#103000 #113000 #123000 #161100 #122100 #102100 #102000 #162100 #130100 #123100 #131000 #110000 #101000 #131000 #153100 #120100 #133000 #161000 #163000 #113000 #162000 #112000 #190000 #173000 #173000 #182000 #080000 #092100 #012100 #002100 #040100 #050100 #020100 #032100 #032000 #031000
#150000 #120000 #161000 #131100 #140100 #131000 #162000 #123000 #113000 #110100 #113100 #151100 #120000 #121000 #142100 #120100 #110100 #121100 #162100 #122000 #110000 #101000 #172000 #080000 #071100 #071100 #092100 #003100 #043100 #012100 #042100 #063000 #021000 #003000 #053000 #061000
#120000 #160000 #122000 #101000 #100000 #100000 #153000 #123100 #151000 #132000 #103000 #130000 #152000 #122000 #131100 #120100 #130100 #160100 #132000 #103000 #162100 #141000 #172000 #070100 #052100 #040100 #041100 #060100 #011100 #040100 #013000 #060000 #042100 #053100 #041000 #032000
#120100 #132100 #131100 #113100 #113000 #113000 #123000 #121000 #153000 #113000 #141000 #160000 #143000 #142000 #152100 #160100 #132100 #130000 #102000 #112000 #113000 #102000 #172000 #070000 #001000 #052100 #002100 #000000 #040100 #012000 #003000 #060000 #051000 #023000 #063000 #012000
#142100 #162100 #133000 #150000 #161000 #151000 #100000 #162000 #111100 #111100 #131000 #141000 #122000 #152000 #143100 #162000 #152100 #120100 #141000 #151000 #190000 #173000 #182000 #070000 #013000 #041000 #000000 #011000 #020000 #002000 #063100 #030100 #000100 #012100 #040100 #012000
#131000 #143000 #102000 #161000 #163000 #162000 #152000 #132000 #121000 #113000 #130000 #112000 #143000 #161000 #151000 #161000 #131000 #160000 #190000 #173100 #182000 #080000 #071100 #092100 #030100 #011100 #000000 #040000 #022000 #060000 #012100 #030100 #033100 #050100 #002000 #041000
#130000 #161000 #142000 #160000 #123000 #163000 #111000 #111000 #121100 #133000 #151000 #122000 #101000 #163000 #133000 #143000 #123000 #120000 #172000 #080000 #071000 #092100 #053100 #050100 #063000 #052000 #032000 #000000 #021000 #053000 #023000 #002000 #060000 #041100 #062100 #063000
#121100 #162000 #100000 #163000 #142000 #140000 #150000 #140100 #160100 #113100 #111100 #151000 #153000 #100000 #102100 #142100 #113100 #130000 #172000 #070000 #040000 #063100 #020100 #013100 #063100 #062100 #063000 #010000 #000000 #031000 #043100 #011100 #021000 #051000 #000000 #010000
#161100 #153000 #122000 #153000 #122000 #101100 #153100 #122100 #132100 #103100 #162100 #123100 #123100 #110100 #102100 #160100 #113000 #190000 #182000 #070000 #062000 #012000 #022100 #022100 #012100 #021000 #001000 #001100 #021100 #040000 #042000 #051000 #000000 #062000 #023000 #010000
#112000 #152000 #122000 #141100 #143100 #142100 #102100 #121100 #122100 #130100 #151100 #133100 #121100 #132100 #113100 #152100 #150000 #172000 #080000 #092100 #042000 #011000 #013000 #032000 #001000 #010000 #030000 #063000 #063000 #062000 #022000 #013000 #040000 #062000 #040000 #052000
#111000 #162000 #130000 #152100 #120100 #163000 #161000 #132100 #120100 #132100 #160000 #153100 #140100 #162100 #160000 #102000 #190000 #182000 #070100 #030100 #011000 #000000 #032000 #042000 #042000 #051000 #023000 #050000 #003000 #062000 #060000 #060000 #022000 #003000 #061000 #051000
#100000 #152000 #143000 #131000 #163000 #141000 #163000 #143000 #142000 #101000 #130000 #161000 #151000 #133000 #103000 #190000 #182000 #080100 #092100 #010000 #033000 #003000 #042000 #023100 #022100 #023100 #061100 #033000 #060000 #032000 #021000 #002000 #063000 #030000 #023000 #052000
#163000 #160000 #101000 #143000 #103000 #150000 #131000 #160000 #130000 #141000 #131000 #140000 #152000 #152000 #102000 #172100 #080100 #092100 #023100 #042000 #003100 #012000 #033000 #012000 #041100 #000100 #051000 #033000 #052000 #042000 #050000 #000000 #011000 #020000 #043000 #003000
#102000 #112000 #162000 #102273 #133000 #141000 #152000 #123000 #151000 #140000 #102000 #141000 #132100 #100100 #133100 #172100 #070100 #030100 #001100 #020000 #032000 #003000 #040000 #062100 #042100 #063000 #033000 #031000 #003100 #000100 #043000 #003000 #040211 #001000 #052000 #060000
#163000 #162000 #111000 #161000 #122000 #162100 #150100 #102000 #112000 #151000 #143000 #141000 #150100 #130100 #123100 #172100 #070100 #032000 #061100 #051100 #012100 #031000 #053000 #062000 #013000 #000000 #053000 #050000 #022000 #012000 #023000 #020000 #040000 #030000 #013000 #013000
#133000 #152000 #113000 #123000 #100000 #121000 #160000 #133000 #142000 #160000 #160000 #113000 #123000 #121000 #140100 #172100 #070100 #042000 #022000 #023000 #010000 #052000 #011000 #063000 #033000 #010000 #030000 #010000 #032000 #052000 #022000 #051000 #060000 #042000 #011000 #010000
41 13 32 4 580
11 16 12 13 11 19
1