222222222222222255555555555555555555
222222222222222225555555555555555555
222222222222222225555555555555555555
222222222222222225555555555555555555
222222222222222225555555555555555555
222222222222222255555555555555555555
222222222222222255555555555555555555
222222222222222255555555555555555555
222222222222222255555555555555555555
222222222222222555555555555555555555
222222222222225555555555555555555555
222222222222255555555555555555555555
222222222222255555555555555555555555
222222222222555555555555555555555555
222222222225555555555555555555555555
222255555555555555555555555555555555
222555555555555555555555555555555555
225555555555555555555555555555555552
555555555555555555555555555552222222
555555555555555555555555555222222222
555555555555555555555555552222222222
555555555555555555555552222222222222
555555555555555555555552222222222222
555555555555555555555552222222222222
555555555555555555555552222222222222
555555555555555555555222222222222222
555555555555555555522222222222222222
555555555555555555522222222222222222
555555555555555555522222222222222222
555555555555555555222222222222222222
555555555555555555222222222222222222
555555555555555552222222222222222222
555555555555555522222222222222222222
555555555555555522222222222222222222
555555555555555522222222222222222222
555555555555555522222222222222222222


