000000110000001100011110000000000000
000000000000111110111111110000000000
000000000000011100111111100100000200
000000001100011110001111100000000000
000000001100001100011111111100000000
000000000001100100111000111000000000
100001100011110001100000000001000000
110000000001110000000100000000000000
110000010011111000000001110001100011
100111100011110000010011000011000000
000000000111110000000110000000000000
000000110011000110000100000000000000
000001111011000000000000000011000000
001000111110000000000000000000000000
001100011100111100000011110011001100
011000000000001111011111111011000000
111100000000001111111110111000000000
110000011111100011111000000000011001
000001111111110000011111100001111100
000011111110000000000111000011111000
000111011100001100000000000111111100
000110000111001111100000111111100000
000000010000001111001001111111001100
111100000000001110000000011010000000
110000001100001011000000000000111110
000000000000000000010011110000111100
000000001000000000000111000000000110
100000011110001110000111110000110000
100001111111111100000011100110000000
000111111111111100010000000000000000
000110011101110000110000000000000000
000000000000000001100001111000000000
000000000000000111101000110000000000
003000000000111111100001100011000000
000001100000111110111000000000000000
000000000000001110000000000000000000

